            NO ./path_to_the_north_texture 

SO          ./path_to_the_south_texture    


F    220,100,0069 
 
WE ./path_to_the_west_texture

C 225,30,0
EA ./path_to_the_east_texture


        1111111111111111111111111
        1000000000110000000000001
        1011000001110000000000001
        100100000000000000000000111111
111111111011111111110000000000001    1
10000000001100000111011111111111111111
11110111111111111100000010001111111111    
11110111111111011101010010001    
11000000110101011100000010001     
10000000000000001100000010001     
10000000000000001101010010001      
11000001110101011111011110N0111      
11110111 1110101 101111010001    
11111111 1111111 111111111111    